7;7
+-+-+-+-+-+-+-+
|       |     |
+ + +-+ + +-+ +
| |     |   | |
+ + +-+ + + + +
|     | | | | |
+-+-+ + + + + +
|     |   |   |
+ +-+-+-+-+-+ +
| |     |     |
+ +-+ + + +-+ +
| |   | | |   |
+ + + + + + +-+
|   | |   |   |
+-+-+-+-+-+-+-+
