7;7
+-+-+-+-+-+-+-+
|       |     |  
+ + +-+ + +-+ +
| |     | |   |
+ + +-+ + + + +
|     |   | | |
+ +-+ +-+-+ + +
| |     |     |
+ + +-+-+ +-+-+
| |     |     |
+ +-+-+ + +-+ +
| |   |   |   |
+ + + +-+-+ +-+
|   |         |
+-+-+-+-+-+-+-+
